"00111101110011001100110011001101",
"00111111100000000000000000000000",
"00111111111100110011001100110011",
"01000000000000000000000000000000",
"01000000000100110011001100110011",
"01000000010000000000000000000000",
"01000000011110011001100110011010",
"01000000100000000000000000000000",
"01000000100000110011001100110011",
"00000000000000000000000000000000",
"10000000000000000000000000000000",
"00000000010101010101010101010101",
"10000000001010101010101010101010",
"10111111001100110011001100110011",
"10111111100000000000000000000000",
"10111111110000000000000000000000",
"11000000000000000000000000000000",
"11000000001001100000000000000000",
"11000000010000000000000000000000",
"11000000011100110011001100110011",
"11000000100000000000000000000000",
"11000000100001100110011001100110",
"01010000001001011001000110000110",
"11010000001001011001000110000110"




"00000000000000000000000000000000",
"00111111100000000000000000000000",
"00111111100000000000000000000000",
"01000000000000000000000000000000",
"01000000000000000000000000000000",
"01000000010000000000000000000000",
"01000000010000000000000000000000",
"01000000100000000000000000000000",
"01000000100000000000000000000000",
"00000000000000000000000000000000",
"10000000000000000000000000000000",
"00000000010101010101010101010101",
"10000000001010101010101010101010",
"10111111100000000000000000000000",
"10111111100000000000000000000000",
"11000000000000000000000000000000",
"11000000000000000000000000000000",
"11000000010000000000000000000000",
"11000000010000000000000000000000",
"11000000100000000000000000000000",
"11000000100000000000000000000000",
"11000000101000000000000000000000",
"01010000001001011001000110000110",
"11010000001001011001000110000110"
